1111111111111
1001CCC0000C1
1000011111001
1P0011E000001
11111111111111