111111
111111
111111
111111
111111
000000