11111111111111111
1P111000000000001
1011000000C000001
10011110000000001
10001110000X00E01
10000000000000001
10000X00000000001
11111111111111111