1111111111111
1111111111111
1111111111111
1P11111101E11
1111111111111