11111111111111
1CC1CCCCCCCC11
11CCC11111C111
1PCC11ECCCCC11
11CCCCCCCCCCC1
1CCCCCCCCCCCC1
11111111111111