1111111111
111111111
11111111111
111111111